101 101
#####################################################################################################
          #   # #     # # # # # # # # # # # # # # #   #       # #   #       # #   # # # #           #
# # # # ### ### # ##### # # # # # # # # # # # # # # ### ####### # ### ####### ### # # # # ####### # #
# # # # # #         # # # #   # #   #                     # #           #   #   # # # #         # # #
# ####### # ######### # # # ### # ### ####### ### # # # ### # ########### ### ### # # # ####### # # #
#     # #           #     #   # # # #       #   # # # #   #     # # # # #   #   # #           # # # #
# ##### # ### ### ### ##### ### # # # ####### ############# ##### # # # # ### ### # ### # ######### #
#           #   # # # #                 # # #       # # # #   #           # #         # #       # # #
# ### # # ### ##### # # ### # # ### # ### # ##### ### # # # ### ### ### ### # ### # ### # # ##### ###
#   # # # # #             # # #   # #           #                 # # #         # #   # # # #     # #
# ######### ##### # # # # ##### ##### ### ################### # ##### ####### ### ########### ##### #
#               # # # # #     #   #     #         # #       # #             #   # # # #   #     # # #
# ### # # # # ####### ##### ### ### # ### ### # ### # ######### # # # # # ######### # # ##### ### # #
#   # # # # #     #       # #     # #   #   # #               # # # # # #     # # #         # # #   #
# ### # ##### # ##### # ####### # # # ##### # # # # ##### # ############### ### # # ######### # # ###
#   # #     # #   #   #       # # # #     # # # # #     # #       # #   # # #           #           #
# ### ### ### # ##### # ### ### ##### ############# ############### # ### ##### ### ##### ### #######
#   #   #   # #     # #   #   #   #             #         #   #             # #   # # # #   #     # #
# ### ######### # ##### # ##### ##### ############# # # ### ### ### ######### # ##### # # ##### ### #
# #       #     #     # #     #     #     #     # # # # # #       #         # #   #     # # # #     #
# ### # ### # # # ##### # # ### # ### # ### ##### ####### # ### ### ######### # ### ##### # # ### # #
#   # #   # # # #     # # #   # #   # #                       #   #                             # # #
# ########### ### ##### # # # # # ##### # # ### # # # # ##### # ### # # ### # ### ####### # # #######
#           # #       # # # # # #     # # #   # # # # #     # #   # # #   # #   #   # # # # #     # #
# # # # ### ##### # ### ### # ### ### # # # ### # ### ### ##### # # # # ##### ### ### # ### # ##### #
# # # #   #   # # #   #   # #   #   # # # # # # # #     #     # # # # #     #   #         # #   #   #
# ##### ### ### ####### # ### # # ####### ### ### # # ########### ##### # ####### ### # ##### ### ###
#     #   #           # #   # # #   # #         # # #           #   #   #     #     # # #           #
# ### ##### # # # # ##### # # ### ### ### # # ##### # # # # # ######### # # ### # ##### # # # # # # #
#   #   #   # # # #     # # # #         # # #   # # # # # # #       #   # #   # #     # # # # # # # #
# ########### # # # # ########### # # ##### # ### ########### # # ##### ### ####### ######### # # # #
#         # # # # # #           # # #     # #   #           # # #   #     #       #     # # # # # # #
# # # ##### ### # # # # # # ####### # # # ### ### ##### # # # ### ##### ### # ####### ### # #########
# # #         # # # # # # #       # # # # #           # # # # #       # #   # # #   # #       # # # #
### # ### # ### ### ### ### # ### ### ####### # # ########### # # # # # ### ### # ##### ####### # # #
#   #   # #   #   #   # #   #   # #         # # #           # # # # # # #             # # #         #
### ####### # # ### # ### # # ##### # # ######### # # # ########### ### # # # # ### ### # # ### # # #
#         # # #   # # #   # #     # # # # # #   # # # #         #     # # # # #   #   # #     # # # #
### ########### ##### ### ### ####### ### # # ### ##### # ##### # # ### # ### ##### ### # ### # # ###
#             #     # #   #       #             #     # #   # # # #   # # #       #         # # #   #
# # ##### # ### ##### ####### ### # # # # ######### # ### ### ##### ### # # # # # # ### ####### # # #
# #     # # # #     #   #       # # # # #         # # #         # # # # # # # # # #   #       # # # #
# # # ### ### ####### ##### # # ### ### # # ############### # ### ### ######### ### ### ### # # ### #
# # #   #           # # #   # # #     # # #         #   # # #             #       # #     # # #   # #
# ### # # # ########### ### ##### # ##### # # ####### ### ####### # ######### # # # ### ####### #####
#   # # # #         #           # #   #   # #       # #         # #       #   # # # #     #   #     #
# ##### # # # ####### # ### ####### # # # ### # ##### ### ################### ##### # # ### ### #####
#     # # # #       # # #         # # # #   # #   # # # #       # # #     #       # # #       #     #
# ### # ### # ####### ##### # ####### ######### ### # # # ####### # # ####### ######### # # #########
#   # #   # #     #     #   #     #         #                 #           #           # # #         #
# # ### ##### # ##### # # # # ####### # # ##### # # # # # ##### ##### # ##### # ######### # # # # ###
# # #     #   #     # # # # #       # # #   #   # # # # #     #     # #     # #         # # # # #   #
# ##### ### # # ######### # # # ##### ### ### # ### # ### # ### ####### ######### # ### ### # ### # #
#   #     # # #         # # # #     #   #   # # #   #   # #           #         # #   #   # #   # # #
# # ### ####### # ### # ####### ##### ### ##### ### # ### # # ######### # # # ##################### #
# # #         # #   # #   #         # #     #   #   #   # # #     #   # # # #           # # #   #   #
# ##### ### # # # ########### # ######### # ### ### ####### # ##### ######### # ##### ### # # ### # #
# #       # # # #           # #         # #   # #         # # # #     #     # #     #   #   #   # # #
####### ##### # ######### ##### ########### ### ### # ##### ### # ##### ####### ##### ### ### ##### #
#           # #         # #               # #     # #     #                 #       #             # #
##### # ### # ### # # ######### ### ### ####### ### # ##### # # ### # # ####### # ### # # # # # ### #
#     #   # #   # # #     #       #   #   #       # #     # # #   # # #     # # # #   # # # # #   # #
### # # ##### ####### # ##### # ############# # ### # ### ### ######### ##### ####### # # # ### #####
#   # #   #         # # # #   #   #     #   # # #   #   # #           #           # # # # #   #     #
### ### ##### # # ####### ### ##### ##### ### # # # # ### # # # # ### # ##### ##### ######### ### ###
#   #       # # #     #           #   # #   # # # # #   # # # # #   # #     #           #   #   #   #
# # ### # # ##### # ##### ### # ### ### # ####### # # ##### ########### # ### # ######### ### ### ###
# # # # # #     # #     # #   # #       #       # # # #               # #   # #             # #     #
##### ### ##### ### ######### ### ####### ######### ### # # # # ### # ### ### # ### # ########### ###
#             # #         #                     #     # # # # #   # #   #   # #   # #           #   #
### # # # # ####### # # ##### # # # ### ######### # ##### ##### # ####### ##### # # # # # # ##### ###
#   # # # #       # # #   #   # # #   #         # # #         # #       #     # # # # # # #     # # #
####### ### # # # ##### ##### ### # ### # # ##### ##### # ##### # # # ### # ####### # # ### # ##### #
#       #   # # # #       #     # #   # # #     # # # # #     # # # #   # # # # # # # #   # #       #
### # # ### # # ##### # # ### ######### ########### # ### ########### ### ### # # ### # ##### # # # #
#   # # #   # #     # # #   #         #       # # # #   #           # #             # #     # # # # #
# # # # ####### ### # # # ### # # # ### # ##### # # # ##### # # # ####### ##### # ############# # # #
# # # # #         # # # #   # # # #   # #                 # # # #       #     # #             # # # #
########### ### ##### # # # # ##### ##### # # # ### # # ####### # # # ### # ### # # # # ########### #
#     #     #       # # # # #   #     #   # # #   # # #       # # # #   # #   # # # # #       # # # #
##### ######### ### ######### ##### ##### ##### # ### # # # ##### ### ### # # ######### # ##### # ###
# #     #         #     #         #   #     #   #   # # # #   # # # # # # # #         # #           #
# ##### ####### ##### ##### # # # ####### ##### # ####### ##### ### ### ################# # ##### ###
#                   #     # # # #       #     # #     #                 # #   # # #     # #     #   #
# ### # # # # # # ### # # # ### ### ### ####### # # ##### # ##### # ##### # ### # # #################
# #   # # # # # # #   # # #   #   #   #       # # #   # # #   # # #           #                     #
### # ##### # # # ### ######### ### ### # # # # ### ### ####### ##### # # # ### ######### ### # # ###
#   # #     # # # #         #     #   # # # # # #                   # # # #       #     #   # # #   #
######### # # # # # # # # ##### ### # # ##### ##### # # # # ### ######### # # # ### ############# ###
#         # # # # # # # #     #   # # #     # #     # # # #   #       #   # # #               # # # #
######### ### ##### ##### ##### # # # # # ### ### # # # ### # # # ####### ### # # # ### ### ### ### #
#         #       # #         # # # # # #   # #   # # # # # # # #     #     # # # #   #   #         #
# # # # # ### ######### # # ### ### ########### # # ##### ####### # ##### ### ### ##### ### ### # # #
# # # # # #       #     # #   # #         # #   # #             # #   # #   #   #     # #     # # # #
##### ### ### # ####### ### # ##### # ##### ####### ### # # # ### # ### ####### # ######### ####### #
#     #     # #   #       # #     # #       # #   #   # # # #   # #           # #       # # # # #   #
### # # # ### # # ### # # # # # # ### ### ### # ### # # # # # # # # # # # ##### # # ##### ### # #####
#   # # # #   # # #   # # # # # # #     #         # # # # # # # # # # # #     # # #               # #
# # # # # # # # # ##### ### # # ### # # # # # # ### # # ### ##### ### # # # # ##### ### # # # ##### #
# # # # # # # # #   #     # # #   # # # # # # #   # # #   #   #     # # # # #   #     # # # #        
#####################################################################################################
